##########
#........#
#..##....#
#........#
#..S.#...#
#....#..E#
#........#
#..##....#
#........#
##########